/* Translation file.
 */
// Uncomment to enable translation!!!
translate = true

language = swedish // mysql collation: general, czech, danish, estonian, hungarian, icelandic, latvian, lithuanian, persian, polish, roman, romanian, slovak, slovenian, spanish, swedish, turkish
Welcome! = Välkommen! // welcome mail subject, see mail.txt
Reminder! = Påminnelse! // remind mail subject, see remind.txt
Forgot password? = Glömt lösenord?
Pings = Pingar

// Buttons
Delete = Radera
Search = Sök
Post = Posta
Edit = Editera
Admin = Admin
Logout = Logga&nbsp;ut
Title = Titel
Publish = Publicera
Upload = Ladda&nbsp;upp
Login = Logga&nbsp;in
Create = Skapa
Register = Registrera
Hide = Göm
Show = Visa
Most&nbsp;Read = Mest&nbsp;Lästa
All = Alla
Save = Spara
Profile = Profil

// Fields
Comments = Kommentarer
Comment = Kommentera
eMail = ePost
Nickname = Smeknamn
Password = Lösenord
Confirm = Upprepa
Body = Brödtext
Public = Publikt
Country = Land
Earth = Jorden
Birthday = Födelsedag
Year = År
Month = Månad
Day = Dag
First&nbsp;Name = Förnamn
Last&nbsp;Name = Efternamn
Gender = Kön
Female = Flicka
Male = Pojke

Show eMail? = Visa ePost?
Show birthday? = Visa födelsedag?
Show country? = Visa land?
Show first name? = Visa förnamn?
Show last name? = Visa efternamn?
Show twitter? = Visa twitter?

// Pagination
First page = Första sidan
Last page = Sista sidan
Go to page = Gå till sida // followed by the number

// Updates
Reminder sent! = Påminnelse skickad!

// Warnings
Are you sure you want to delete the article? = Är du säker på att du vill ta bort artikeln?

// Benine errors
Check your inbox! = Kolla din inbox!
Wrong password! = Fel lösenord!
User not found! = Användare ej funnen!
Key not found! = Nyckel ej funnen!
That's not an eMail! = Ogiltig ePost!
eMail already in use! = ePost används redan!
Nickname already in use! = Smeknamn används redan!
Passwords don't match! = Lösenorden stämmer inte överens!
eMail not found! = ePost ej funnen!

// Malign errors
You are not authorized! = Du saknar rättigheter!
You are not an administrator! = Du är inte administratör!
You need to login! = Du måste logga in!

// See verify.html
Verify your eMail address by clicking on the link sent in a mail to you. = Verifiera din ePost adress genom att klicka på länken i mailet vi skickat.
Profile saved! = Profilen sparad!

// Months
January = Januari
February = Februari
Mars = Mars
April = April
May = Maj
June = Juni
July = Juli
August = Augusti
September = September
October = Oktober
November = November
December = December

// Countries (this makes little sense since all international sites 
// where you can choose country should be in english) duh...
// http://www.foreignword.com/countries/
// The 4 below are not translated by foreignword...
AX = Åland
ME = Montenegro
PS = Palestina
RS = Serbien

AF = Afghanistan
AL = Albanien
DZ = Algeriet
VI = Amerikanska Jungfruöarna
AS = Amerikanska Samoa
AD = Andorra
AO = Angola
AI = Anguilla
AQ = Antarktis
AG = Antigua och Barbuda
AR = Argentina
AM = Armenien
AW = Aruba
AU = Australien
AZ = Azerbajdzjan
BS = Bahamas
BH = Bahrain
BD = Bangladesh
BB = Barbados
BE = Belgien
BZ = Belize
BJ = Benin
BM = Bermuda
BT = Bhutan
BO = Bolivia
BA = Bosnien och Hercegovina
BW = Botswana
BV = Bouvetön
BR = Brasilien
VG = Brittiska Jungfruöarna
IO = Brittiska territoriet i Indiska Oceanen
BN = Brunei
BG = Bulgarien
BF = Burkina Faso
BI = Burundi
KY = Caymanöarna
CF = Centralafrikanska republiken
CL = Chile
CO = Colombia
CK = Cooköarna
CR = Costa Rica
CY = Cypern
DK = Danmark
TF = Franska territorierna i södra Indiska oceanen
CD = Demokratiska republiken Kongo
DJ = Djibouti
DM = Dominica
DO = Dominikanska republiken
EC = Ecuador
EG = Egypten
GQ = Ekvatorialguinea
SV = El Salvador
CI = Elfenbenskusten
ER = Eritrea
EE = Estland
ET = Etiopien
FO = Färöarna
AE = Förenade Arabemiraten
GB = Förenade kungariket
US = Förenta staterna
UM = Förenta staternas mindre öar i Oceanien och Västindien
FK = Falklandsöarna
FJ = Fiji
PH = Filippinerna
FI = Finland
FR = Frankrike
GF = Franska Guyana
PF = Franska Polynesien
GA = Gabon
GM = Gambia
GE = Georgien
GH = Ghana
GI = Gibraltar
GL = Grönland
GR = Grekland
GD = Grenada
GP = Guadeloupe
GU = Guam
GT = Guatemala
GN = Guinea
GW = Guinea-Bissau
GY = Guyana
HT = Haiti
HM = Heardön och McDonaldöarna
VA = Heliga stolen
HN = Honduras
HK = Hongkong
IN = Indien
ID = Indonesien
IQ = Irak
IR = Iran
IE = Irland
IS = Island
IL = Israel
IT = Italien
JM = Jamaica
JP = Japan
JO = Jordanien
YU = Jugoslavien
MK = Makedonien f.d. jugoslaviska republiken
CX = Julön
KH = Kambodja
CM = Kamerun
CA = Kanada
CV = Kap Verde
KZ = Kazakstan
KE = Kenya
CN = Kina
KG = Kirgizistan
KI = Kiribati
CC = Kokosöarna
KM = Komorerna
CG = Kongo
HR = Kroatien
CU = Kuba
KW = Kuwait
LA = Laos
LS = Lesotho
LV = Lettland
LB = Libanon
LR = Liberia
LY = Libyen
LI = Liechtenstein
LT = Litauen
LU = Luxemburg
MO = Macao
MG = Madagaskar
MW = Malawi
MY = Malaysia
MV = Maldiverna
ML = Mali
MT = Malta
MA = Marocko
MH = Marshallöarna
MQ = Martinique
MR = Mauretanien
MU = Mauritius
YT = Mayotte
MX = Mexiko
FM = Mikronesien
MZ = Moçambique
MD = Moldavien
MC = Monaco
MN = Mongoliet
MS = Montserrat
MM = Myanmar
NA = Namibia
NR = Nauru
NL = Nederländerna
AN = Nederländska Antillerna
NP = Nepal
NI = Nicaragua
NE = Niger
NG = Nigeria
NU = Niue
KP = Nordkorea
MP = Nordmarianerna
NF = Norfolkön
NO = Norge
NC = Nya Kaledonien
NZ = Nya Zeeland
OM = Oman
AT = Österrike
TL = Östtimor
PK = Pakistan
PW = Palau
PA = Panama
PG = Papua Nya Guinea
PY = Paraguay
PE = Peru
PN = Pitcairn
PL = Polen
PT = Portugal
PR = Puerto Rico
QA = Qatar
RE = Réunion
RO = Rumänien
RW = Rwanda
RU = Ryssland
ST = São Tomé och Príncipe
KN = Saint Christopher och Nevis
SH = Saint Helena
LC = Saint Lucia
PM = Saint Pierre och Miquelon
VC = Saint Vincent och Grenadinerna
SB = Salomonöarna
WS = Samoa
SM = San Marino
SA = Saudiarabien
CH = Schweiz
SN = Senegal
SC = Seychellerna
SL = Sierra Leone
SG = Singapore
SK = Slovakien
SI = Slovenien
SO = Somalia
ES = Spanien
LK = Sri Lanka
SD = Sudan
SR = Surinam
SJ = Svalbard och Jan Mayen
SE = Sverige
SZ = Swaziland
ZA = Sydafrika
GS = Sydgeorgien och Sydsandwichöarna
KR = Sydkorea
SY = Syrien
TJ = Tadzjikistan
TW = Taiwan
TZ = Tanzania
TD = Tchad
TH = Thailand
CZ = Tjeckien
TG = Togo
TK = Tokelau
TO = Tonga
TT = Trinidad och Tobago
TN = Tunisien
TR = Turkiet
TM = Turkmenistan
TC = Turks- och Caicosöarna
TV = Tuvalu
DE = Tyskland
UG = Uganda
UA = Ukraina
HU = Ungern
UY = Uruguay
UZ = Uzbekistan
EH = Västsahara
VU = Vanuatu
VE = Venezuela
VN = Vietnam
BY = Vitryssland
WF = Wallis och Futuna
YE = Yemen
ZM = Zambia
ZW = Zimbabwe
